W W W W W W W W W W W W W W W W
W W P R B R D W W D R B R D W W
W C W R R R B W W B R R R W B W
W R R W B R R W W R R R W B R W
W B R B W R R W W R R W B R D W
W R R R R W R R R R W B R R R W
W B R B B B W R R W R R R R R W
W D R R R R R R R R R R B B B W
W W W W W W W W W W W W W W W W