W W W W W W W W W W W W W W W W
W P B B B B B B B B B B B R R W
W R R R R R R R R R R R R R D W
W W W W W W W W W W W W W R R W
W D R B B B B B B B B B B R R W
W R R R R R R R R R R R R R B W
W R R W W W W W W W W W W W W W
W D R R R R R R R R R R R D C W
W W W W W W W W W W W W W W W W