W W W W W W W W W W W W W W W W
W P R B D R B W B R R R B D R W
W R R R R R R W D R R R R B R W
W R R R R R R W R R R R R R R W
W B R B B B R W B B R R R C R W
W R R R R B R W B B R R R R B W
W R R R D R R W R R R R R B R W
W B B R R R R R R R R R D R R W
W W W W W W W W W W W W W W W W