W W W W W W W W W W W W W W W W W W W W W W W W W W W W W W W W W W W W W W W W W W W W W W W W
W - - - - - R R - - - - - W - - - - - - - W R R - - - - - - - - - - - - - R R R R - - - - - R W
W - - - - - - - - - - - - W - - - - - - - W - - - - - - - - - - - - W - - - - - - - - - - - R W
W - - - - - - - - - - - - W - - - - - - - W - - - - - - - - - - - - W - - - - - - - - - - - R W
W - W W W - - - - - - - - W - - - - - - - W - - - W - - - - W - - - W - - - - - - - - - - - R W
W - - - W - - - - - - - - - - - - - - - - - - - - W - - - - W - - - W - - - - - - - - - - - R W
W - - - W R R W W R R R W W W R R R R R W W - - - - W - - - - W - - W - - - - - - - - - - - R W
W - - - W W W W W W W W W W W W W W W W W W W W R R R R R R R R R R W W W R R R R - - - - - R W
W - P - W - - - - - - - - R - - W - - - W W W W W W W W W W W W W W W W W W W W W W W - - - R W
W W W W W - - - - - - - - - B - W - B - - - - - - - W W W - - - - R - - - R R R - - - - - - R W
W - - - W - - W - - - - - - W - W - W W W - - R - - W - - - - - - - - - - - - - - - - - - - R W
W - C - W - - W - - - - - - - - W - - - W - - R - - W - W - - - - - - - - - - - - - - - - - R W
W - - - - - - W R R R R R - - - - - - - - - - R - - - - W - - R - - - - - - - - - - - - - - R W
W W W W W W W W W W W W W W W W W W W W W W W W W W W W W W W W W W W - - - W - - - - W W W W W
- - - - - - - - - - - - - - - - - - - - - - - - - - - - - - - - - - - - - - - - - - - - - - - -